111111111111111111111111111111111111111111111111
100000000000000000000000000000000000000000000001
100000000000000000000000000000000000000000000001
100001000000000100010001111111001110010001000001
100001000000000100101000001000010001010001000001
100000100000001001000100001000100000011111000001
100000100010001011111110001000100000011111000001
100000010101010100000001001000010001010001000001
100000011000110100000001001000001110010001000001
100000000000000000000000000000000000000000000001
100000000000011100010000010111111100220000000001
100000000000100010010000010000100000220000000001
100000000001000001010000010000100000220000000001
100000000001000001010000010000100000220000000001
100000000000100010001000100000100000000000000001
100000000000011100000111000000100000110000000001
100000000000000000000000000000000000000000000001
100000000000000000000000000000000000000000000001
100000000000000000000060000000000000007000000001
100000000000000000000000000000000000000000000001
100000000000000002200000000000000000000000000001
100000000000000002200000000000000000000000000001
100000000000000002200000050000000000000000000001
100000000000220002200000000000000000050000000001
100400000000220000000000000005000000000000000001
100000000000220000000000000000000000000000000001
111111111111111111111111111111111111111111111111
111111111111111111111111111111111111111111111111
000000000000000000000000000000000000000000000000
000000000000000000000000000000000000000000000000
000001000000000100010001111111001110010001000000
000001000000000100101000001000010001010001000000
000000100000001001000100001000100000011111000000
000000100010001011111110001000100000011111000000
000000010101010100000001001000010001010001000000
000000011000110100000001001000001110010001000000
000000000000000000000000000000000000000000000000
000000000000011100010000010111111100220000000000
000000000000100010010000010000100000220000000000
000000000001000001010000010000100000220000000000
000000000001000001010000010000100000220000000000
000000000000100010001000100000100000000000000000
000000000000011100000111000000100000330000000001
000000000000000000000000000000000000000000000011
000000000000000000001111111111111111111110000111
000000000000000000001000000000700000000700001111
000000000000000000001000000000000000000000011111
000000000000000000001000000000000009000000111111
111111111111111111111000001111111111111111111111
000000000000000000001000000007000000000700000000
000000000000000000001000000000000000000000000000
040001000000000000000000001000000000000000000055
000011000000000600000000001000000000000000000055
111111111111111111111111111100010090100001009011
111111111111111111111111111111111111111111111111
100000000000000000000000000000000000000000000001
100000000000000000000000000000000000000000000001
100000001000000000100010000010000001000000000001
100000001000000000100101000010000001000000000001
100000000100000001001000100010000001000000000001
100000000100010001011111110010000001000000000001
100000000010101010100000001010000001000000000001
100000000011000110100000001011111101111110000001
100000000000000000000000000000000000000000000001
100000000111111101000000010100010111110000000001
100000000000100001000000010110110100001000000001
100000000000100001000000010101010100001000000001
100000000000100001000000010103010111110000000001
100000000100100000100000100105010100000000000001
100000000011000000011111000100010100000000000001
100000000000000000000000000100010000000000000001
100000000000000000000000000100010000000000000001
100000000000000000000000000100010000000000000001
100000000000000000000000000100010000000000000001
100000000000000000000000000100010000000000000001
100000000000000000000000000100010000000000000001
100000000000000000000000000100010000000000000001
100000000000000000000000000100010000000000000001
100400000000000000000000000000010000000000000001
100000000000000000000000000000010000000000000001
111111111111111111111111111111111111111111111111
111111111111111111111111111111111111111111111111
000000000000000000000000000000000000000000000000
000000000000000000000000000000000000000000000000
000000000000000000000000000000000000000000000000
000000111110000000100000001111110100000100000000
000000100001000001010000010000000100000100000000
000000100000100010001000010000000111111100000000
000000100000100111111100001111100111111100000000
000000100001001000000010000000010100000100000000
000000111110001000000010011111000100000100000000
000000000000000000000000000000000000000000000000
000000000000000000000000100000000000000000000000
000000000000000000000001110000000000000000000000
000000000000000000000000100000000000000000000000
000000000000000000000000000000000000000000000000
000000011111110100000001001000000101111100000000
000000000010000100000001001100001101000010000000
000000000010000100000001001010010101000010000000
000000000010000100000001001001100101111100000000
000000010010000010000010001000000101000000000000
000000001100000001111100001000000101000000000000
000000000000000000000000000000000000000000000000
000000000000000000000000000000000000000000000000
000000000000000000000000000000000000000000000000
000400000000000000000000000000000000030000000000
000000000055550000000000000000000000000000000000
111111111000000000000000000111111111111111111111
111111111111111111111111111111111111111111111111
000000000000000000000000000000000000000000000000
000000000000000000000000000000000000000000000000
000000000000000000000000000000000000000000000000
000000111110000000100000001111110100000100000000
000000100001000001010000010000000100000100000000
000000100000100010001000010000000111111100000000
000000100000100111111100001111100111111100000000
000000100001001000000010000000010100000100000000
000000111110001000000010011111000100000100000000
000000000000000000000000000000000000000000000000
000000000000000000000000000000000000000000000000
000001000000111101000101111101111101111100000000
000001000001000001000100010001000000010000000000
000001000001000001000100010001000000010000000000
000001000000111001111100010001110000010000000000
000001000000000101000100010001000000010000000000
000001000000000101000100010001000000310000000000
000001111101111001000101111101000000010000000000
000000000000000000000000000000000000000000000000
000000000000000000000000000000000000000000000000
000000000000000000000000000000000000000000000000
000000000000000000000000000000000000000000000000
000000000000000000000000000000000000000000000000
000400000000000000000000000000000000000000000000
000000000055555500000000000000000000000000000000
111111111000000001111111111111111111111111111111
111111111111111111111111111111111111111111111111
000000000000000000000000000000000000000000000000
000000000000000000000000000000000000000000000000
000000000000000000000000000000000000000000000000
000000111111101000000010010000001011111000000000
000000000100001000000010011000011010000100000000
000000000100001000000010010100101010000100000000
000000000100001000000010010011001011111000000000
000000100100000100000100010000001010000000000000
000000011000000011111000010000001010000000000000
000000000000000000000000000000000000000000000000
000000000000000000000000000000000000000000000000
000000000111101111000010000001110011111000000000
000000001000001000100101000010001010000000000000
000000001000001000100101000100000010000000000000
000000000111001111001000100100000011100000000000
000000000000101000001111100100000010000000000000
000000000000101000010000010010001010000000000000
000000001111001000010000010001110011111000000000
000000000000000000000000000000000000000000000000
000000000000000000000000000000000000000000000000
000000000000000000000000000000000000000000000000
000000000005000000000000500000000000000000000000
000000000000000000000000000000000000000000000000
000400000000000000000000000000000000000003000000
000000000000000000000000000000000000000000000000
111111110000000111110000000111111111111111111111
111111111111111111111111111111111111111111111111
000000000000000000000000000000000000000000000000
000000000000000000000000000000000000000000000000
000000000000000000000000000000000000000000000000
000000110000000100011100010000000101111111000000
000000101000001100100010010000000101000000000000
000000100100010101000001001000001001111000000000
000000100010100101000001000100010001000000000000
000000100001000100100010000010100001000000000000
000000100000000100011100000001000001111111000000
000000000000000000000000000000000000000000000000
000000001000000000000000000000000000000100000000
000000010000000000000000000000000000000010000000
000000111111111111111100001111111111111111000000
000000010000000000000000000000000000000010000000
000000001000000000000000000000000000000100000000
000000000000000000000000000000000000000000000000
000000000000000000000000000000000000000000000000
000000000000000000000000100000000000000000000000
000000000000000000000000100000000000000000000000
000000000000000000000010101000000000000000000000
000000000000000000000001110000000000000000000000
000000000000000000000000100001000000000000000000
000000000000000000000000000010000000000000000000
000400000000000000000000300111110000000000000000
000000000000000000000000000010000000000000000000
111111111111111111111111111111111111111111111111
