111111111111111111111111111111111111111111111111
000000000000000000000000000000000000000000000000
000000000000000000000000000000000000000000000000
000000000000000000000000000000000000000000000000
000000110000000100011100010000000101111111000000
000000101000001100100010010000000101000000000000
000000100100010101000001001000001001111000000000
000000100010100101000001000100010001000000000000
000000100001000100100010000010100001000000000000
000000100000000100011100000001000001111111000000
000000000000000000000000000000000000000000000000
000000001000000000000000000000000000000100000000
000000010000000000000000000000000000000010000000
000000111111111111111100001111111111111111000000
000000010000000000000000000000000000000010000000
000000001000000000000000000000000000000100000000
000000000000000000000000000000000000000000000000
000000000000000000000000000000000000000000000000
000000000000000000000000100000000000000000000000
000000000000000000000000100000000000000000000000
000000000000000000000010101000000000000000000000
000000000000000000000001110000000000000000000000
000000000000000000000000100001000000000000000000
000000000000000000000000000010000000000000000000
000400000000000000000005000111110000000003000000
000000000000000000000000000010000000000000000000
111111111111111111111111111111111111111111111111
